NO ./textures/Background.png
SO ./textures/Background2.png
WE ./textures/Background3.png
EA ./textures/Background2.png

F 220,100,0
C 225,30,0


11111111111111111111111
100000000000000000000111111
100000000000000000000111111
100010000000000000000111111
1000E1000000000000000111111
100000000000000000000111111
100000000000000000000111111
11111111111111111111111

