NO ./textures/bba.png
SO ./textures/bbb.png
WE ./textures/bba.png
EA ./textures/bbb.png

F 220,100,0
C 225,30,0


11111111111111111111111111
100000000000000000000111111
100000000000000000000111111
100000000000000000000111111
100000000000000000000111111
100000000000000000000111111
100000000000000000000111111
100000000000000000000111111
100000000000000000000111111
100000000000000000000111111
100000000000000000000111111
100000000000000000000111111
100000000000000000000111111
100010000000000000000111111
1000E1000000000000000111111
100000000000000000000111111
100000000000000000000111111
1111111111111111111111

