C 0,0,51

F 0,0,5
EA ./textures/bba.png
SO ./textures/bbb.png
NO ./textures/bba.png
WE ./textures/bba.png


            1111111111111111111111111
11111111111111111111111111111111111111111111
100000000011000000000000000000000000000000001
101100000111000000000000000000000000000000001
1001000000000000000000000000000000000000000011111111
11111111101100000111000000000000000000000000000000001
10000000001100000111000000010000000000000111001111111
1111011111111101110000000000000000000000000010001
111101111111110111010000000000000000000010010001S1
110000001101010111000000000000000000000000001000101
1000000000000000110000000000000000000000000010001101
1000000000000000110100000000000000000000010010001111
110000011101010111110000000000000000000001111000111
11110111 1110101 10111101000111111111111111111111
11111111 1111111 11111111111111111111111111111111
11111111 1111111 11111111111111111111111111111111
