NO ./textures/Background.png
SO ./textures/Background1.png
WE ./textures/Background1.png
EA ./textures/Background1.png

F 220,100,0
C 225,30,0

    1111111111111111111111111
11111111000000111111000011111111
1000000000000000000000000000001
11111111100000010000010000000001
111111111000001011001 10000000001
110000000000000000001 10000000001          1    
1000000001E1111111111 10000000000111111111101111
100000000101111111111 11111111110000000000000001
100000000101111111111 10000000000111111111111101
100000000101111111111 10000000000111111111111101
100000000101111111111 10000000000111111111111101
100000000101111111111 10000000000111111111111101
111111111111111111111 11111111111111111111111111

