NO ./path_to_the_north_texture
SO ./path_to_the_south_texture
WE ./path_to_the_west_texture
EA ./path_to_the_east_texture

F 220,100,0
C 225,30,0

    1111111111111111111111111
11111111000000111111000011111111
10000000000000000000000W00000001
11111111100000010000010000000001
111111111000001011001 10000000001
110000000000000000001 10000000001
100000000101111111111 10000000000111111111111111
100000000101111111111 11111111110000000000000001
100000000101111111111 10000000000111111111111101
100000000101111111111 10000000000111111111111101
100000000101111111111 10000000000111111111111101
100000000101111111111 10000000000111111111111101
111111111111111111111 11111111111111111111111111